111111111111111111
1000000E0C00100001
100100000P00000001
111111111111111111