1111111111111111111
100C0000001C1000001
10000000001E1000001
10000000000P0000001
1111111111111111111
