1111111111111111111
1C0E0000P0000000001
1000000000000000001
1000000000000000001
1000000000000000001
1111111111111111111